00000008
00000028
00380000
00380000
00380000
00181008
00380000
00380000
00380000
03380000
00380000
00380000
00380000
00282018
00283018
00380000
00380000
00380000
00380000
00380000
00380000
00380000
00380000
00380000
00380000
00380000
00380000
00380000
05380000
00380000
07380000
00380000
00380000
00380000
00184840
00380000
00380000
00380000
03380000
00380000
00380000
00380000
