00000010
0000000A
0000000000000000
0000000000000000
401C000000000000
4000000000000000
4014000000000000
4022000000000000
401199999999999A
4014000000000000
4022000000000000
401199999999999A
