; define levels in graph
dq avoid 	? 0x0000000000000000
dq A 		? 0x0000000000000000
dq b 		? 0x401C000000000000
dq C 		? 0x4000000000000000
dq D 		? 0x4014000000000000
dq E 		? 0x4022000000000000
dq F 		? 0x401199999999999A
dq G 		? 0x4014000000000000
dq K 		? 0x4022000000000000
dq I 		? 0x401199999999999A

ADD A B C
MUL C D E
MUL C F G
ADD K I C
